0 ,0 ,42,0 ,0 ,0 ,0 ,0 ,0 ,0 ,0 ,0 ,0 ,0
8 ,8 ,0 ,8 ,8 ,8 ,8 ,8 ,8 ,8 ,8 ,8 ,8 ,8
8 ,0 ,0 ,0 ,8 ,0 ,32,0 ,31,0 ,0 ,8 ,0 ,8
8 ,0 ,0 ,0 ,8 ,0 ,0 ,0 ,0 ,0 ,0 ,8 ,0 ,8
8 ,1 ,9 ,0 ,71 ,0 ,0 ,662,0 ,653,0 ,723 ,2 ,8
8 ,0 ,0 ,0 ,8 ,0 ,0 ,0 ,0 ,0 ,0 ,8 ,0 ,8
8 ,0 ,0 ,0 ,8 ,0 ,32,0 ,0 ,0 ,0 ,8 ,0 ,8
8 ,0 ,31,0 ,52,0 ,0 ,621,0 ,0 ,0 ,8 ,0 ,8
8 ,8 ,8 ,8 ,8 ,8 ,8 ,8 ,8 ,8 ,8 ,8 ,8 ,8
0 ,0 ,0 ,0 ,0 ,0 ,0 ,0 ,0 ,0 ,0 ,0 ,0 ,0