0,0,42,0,0,0,0,0,0,0,0,0,0,0
8,8,0,8,8,8,8,8,8,8,8,8,8,8
8,0,0,0,8,0,32,0,31,0,0,8,0,8
8,0,0,0,8,0,0,0,0,0,0,8,0,8
8,1,9,0,7,0,0,66,0,65,0,7,2,8
8,0,0,0,8,0,0,0,0,0,0,8,0,8
8,0,0,0,8,0,32,0,0,0,0,8,0,8
8,0,31,0,52,0,0,62,0,0,0,8,0,8
8,8,8,8,8,8,8,8,8,8,8,8,8,8
0,0,0,0,0,0,0,0,0,0,0,0,0,0