0,0,11,0,0,0,0,0,0,0,0,0,0,0
10,10,0,10,10,10,10,10,10,10,10,10,10,10
10,0,0,0,10,0,3,0,4,0,0,10,0,10
10,0,0,0,10,0,0,0,0,0,0,10,0,10
10,1,12,0,9,0,0,7,0,8,0,9,2,10
10,0,0,0,10,0,0,0,0,0,0,10,0,10
10,0,0,0,10,0,4,0,0,0,0,10,0,10
10,0,3,0,5,0,0,6,0,0,0,10,0,10
10,10,10,10,10,10,10,10,10,10,10,10,10,10
0,0,0,0,0,0,0,0,0,0,0,0,0,0