0,0,0,8,8,8,8,8,8,8,8,8
8,1,0,0,0,42,0,8,0,31,0,8
8,0,92,0,0,0,32,8,0,0,0,8
8,0,0,0,0,0,0,8,0,0,0,8
8,0,0,0,8,8,8,8,0,0,0,8
8,0,0,0,8,8,8,8,0,0,0,8
8,31,0,0,0,0,0,0,0,32,0,8
8,0,0,0,0,0,0,0,0,8,8,8
8,0,0,0,0,0,0,0,0,71,2,8
8,8,8,8,8,8,8,8,8,8,8,8