8,8,8,8,8,8,8,8,8,8,8,8
8,32,52,51,0,0,0,0,0,0,0,8
8,0,0,8,0,0,0,0,0,0,0,8
8,51,8,8,32,0,0,31,0,0,0,8
8,0,0,0,0,0,0,0,0,0,0,8
8,0,0,0,0,0,0,0,0,8,0,8
8,0,0,0,0,0,0,31,0,621,0,8
8,0,0,0,0,0,0,0,8,8,71,8
8,44,0,0,32,0,0,0,1,51,2,8
8,8,8,8,8,8,8,8,8,8,8,8