8,8,8,8,8,8,8,8,8,8,8,8,8,8
8,0,32,0,0,0,72,0,0,0,8,1,42,8
8,0,0,0,0,0,8,0,0,0,8,0,0,8
8,0,0,0,0,0,8,32,0,0,8,0,0,8
8,0,0,0,0,0,8,0,8,71,8,0,0,8
8,611,0,0,0,0,51,0,0,0,0,0,32,8
8,0,0,0,0,0,8,31,0,0,0,0,0,8
8,8,8,0,0,0,8,0,0,0,0,0,8,8
8,2,73,0,613,0,8,0,0,0,0,0,612,8
8,8,8,8,8,8,8,8,8,8,8,8,8,8