0,0,0,0,8,8,8,8,8,8,8,8
8,42,1,0,0,0,0,0,8,0,2,8
8,0,0,0,0,0,0,0,71,0,0,8
8,0,0,0,0,0,0,0,8,8,8,8
8,0,0,0,0,0,0,0,0,0,0,8
8,0,0,0,0,0,0,0,0,0,0,8
8,0,0,0,0,0,0,0,0,0,0,8
8,31,0,32,0,32,0,32,0,32,611,8
8,8,8,8,8,8,8,8,8,8,8,8