8,8,8,8,8,8,8,8,8,8,8,8,8,8
8,42,0,32,0,0,51,0,0,0,0,0,612,8
8,0,0,0,0,0,8,0,32,0,0,8,8,8
8,0,0,0,0,0,8,0,0,0,0,72,0,8
8,31,0,91,0,0,71,0,0,0,0,8,0,8
8,0,0,0,0,0,8,0,0,0,0,8,0,8
8,0,0,0,0,0,8,0,0,0,0,8,2,8
8,0,0,0,0,0,8,0,0,0,0,8,8,8
8,1,0,31,0,0,51,0,0,0,0,0,611,8
8,8,8,8,8,8,8,8,8,8,8,8,8,8