8,8,8,8,8,8,8,8,8,8,8,8,8,8
8,91,72,0,612,8,0,0,0,0,0,0,613,8
8,8,8,0,0,8,0,0,0,0,0,0,0,8
8,0,0,0,0,8,0,0,0,0,8,73,8,8
8,0,0,0,0,71,0,0,0,0,8,0,0,8
8,32,0,0,0,8,0,32,0,0,8,0,0,8
8,0,0,0,0,8,0,0,0,0,8,0,0,8
8,1,0,0,0,8,0,0,0,0,8,0,0,8
8,44,0,0,0,51,0,0,0,611,8,0,2,8
8,8,8,8,8,8,8,8,8,8,8,8,8,8