8,8,8,8,8,8,8,8,8,8,8,8,8,8
8,42,1,0,0,0,0,0,0,0,0,0,31,8
8,51,0,0,0,0,0,0,0,0,0,0,0,8
8,51,0,0,0,0,0,0,0,0,0,8,71,8
8,51,0,0,0,0,0,0,0,0,0,8,2,8
8,51,0,32,0,32,0,0,0,0,0,51,611,8
8,51,8,8,0,8,8,8,8,0,0,8,8,8
8,51,0,0,0,0,0,32,8,0,0,0,0,8
8,31,0,0,0,0,0,32,8,0,0,0,31,8
8,8,8,8,8,8,8,8,8,8,8,8,8,8