8,8,8,8,8,8,8,8,8,8,8,8
8,1,0,31,0,0,0,32,0,71,0,8
8,0,0,0,0,0,0,0,0,8,0,8
8,0,0,0,0,0,0,0,0,8,0,8
8,0,0,0,0,0,0,0,0,8,0,8
8,44,0,0,0,52,0,0,611,8,0,8
8,0,0,0,0,0,0,0,0,8,0,8
8,0,0,0,0,0,0,0,0,8,0,8
8,0,0,32,0,0,0,31,0,8,2,8
8,8,8,8,8,8,8,8,8,8,8,8