8,8,8,8,8,8,8,8,8,8,8,8,8,8
8,44,0,31,0,0,71,0,0,0,0,0,0,8
8,1,0,0,0,0,8,0,0,0,0,0,0,8
8,8,8,51,8,51,8,31,8,8,8,72,8,8
8,0,0,0,0,0,0,0,8,0,0,0,0,8
8,0,0,32,0,31,0,0,611,0,0,0,0,8
8,0,0,0,0,0,0,0,8,0,0,0,0,8
8,613,0,0,0,0,0,0,32,0,0,8,73,8
8,0,0,0,0,0,0,612,8,0,0,8,2,8
8,8,8,8,8,8,8,8,8,8,8,8,8,8