0,0,0,8,8,8,8,8,8,8,8,8
8,42,0,8,0,92,0,31,0,8,0,8
8,0,0,8,0,0,8,0,0,8,0,8
8,0,0,8,611,32,8,0,8,8,0,8
8,0,0,71,0,0,8,0,0,72,2,8
8,0,0,8,0,0,8,0,8,8,0,8
8,0,0,8,0,0,8,0,0,8,0,8
8,51,8,8,0,0,8,0,0,8,0,8
8,94,0,0,0,0,0,91,0,8,0,8
8,8,8,8,8,612,8,8,8,8,8,8