8,8,8,8,8,8,8,8,8,8,8,8,8,8
8,2,0,0,0,0,8,0,612,32,8,0,91,8
8,0,0,0,0,0,8,0,0,0,8,71,8,8
8,8,8,8,8,73,8,0,0,0,0,0,0,8
8,613,0,0,0,0,72,0,0,0,0,0,0,8
8,0,0,0,0,0,8,0,0,0,0,0,0,8
8,0,0,0,0,0,8,0,0,0,0,0,1,8
8,32,0,0,0,0,8,0,0,0,0,0,0,8
8,44,0,0,0,0,51,0,0,0,0,0,611,8
8,8,8,8,8,8,8,8,8,8,8,8,8,8