8,8,8,8,8,8,8,8,8,8,8,8,8,8
8,42,0,0,0,0,32,0,611,0,0,71,31,8
8,0,0,0,0,0,0,0,0,0,0,8,8,8
8,0,0,0,0,8,0,8,0,0,0,0,0,8
8,31,0,0,0,51,32,0,0,0,0,0,0,8
8,0,0,0,0,8,0,8,0,0,0,0,0,8
8,0,0,0,0,0,0,0,0,0,0,0,0,8
8,0,0,0,0,0,0,0,0,0,0,8,72,8
8,1,0,0,0,0,0,0,0,0,612,8,2,8
8,8,8,8,8,8,8,8,8,8,8,8,8,8