8,8,8,8,8,8,8,8,8,8,8,8,8,8
8,42,8,2,8,32,0,31,8,32,0,31,0,8
8,0,71,0,8,0,0,0,8,0,0,0,0,8
8,0,8,8,8,0,0,0,8,0,0,0,0,8
8,0,8,611,51,0,51,0,51,0,51,0,31,8
8,0,8,8,8,0,8,0,0,0,8,0,0,8
8,0,0,1,0,0,8,0,0,0,8,0,0,8
8,0,0,0,0,0,8,0,0,0,8,0,0,8
8,31,0,0,0,32,8,31,0,32,8,0,32,8
8,8,8,8,8,8,8,8,8,8,8,8,8,8