8,8,8,8,8,8,8,8,8,8,8,8
8,1,0,0,0,0,0,0,0,0,42,8
8,0,0,0,0,0,0,0,0,0,0,8
8,0,0,0,0,0,0,0,0,0,0,8
8,0,0,0,0,8,0,8,0,0,0,8
8,32,0,0,0,51,0,51,0,0,32,8
8,0,0,0,0,8,0,8,0,0,0,8
8,71,8,0,0,0,0,0,0,0,0,8
8,2,8,0,0,0,611,0,0,0,0,8
8,8,8,8,8,8,8,8,8,8,8,8