8,8,8,8,8,8,8,8,8,8,8,8
8,94,0,51,0,0,0,0,0,0,611,8
8,0,0,8,0,0,0,0,0,32,32,8
8,0,0,71,0,0,0,0,0,0,0,8
8,51,51,8,0,0,0,0,0,0,0,8
8,0,0,0,0,0,0,0,0,0,0,8
8,0,0,0,0,0,0,8,51,8,72,8
8,0,0,0,0,0,0,8,0,8,0,8
8,41,0,0,1,0,0,8,612,8,2,8
8,8,8,8,8,8,8,8,8,8,8,8