8,8,8,8,8,8,8,8,8,8,8,8,8,8
8,42,0,0,0,0,0,0,0,0,0,0,0,8
8,0,0,0,32,0,0,0,92,0,0,0,611,8
8,0,0,0,0,0,0,0,0,0,0,0,0,8
8,0,0,0,0,0,0,0,0,0,0,0,0,8
8,0,0,0,0,0,0,0,0,0,0,0,0,8
8,31,0,0,32,0,0,0,0,0,0,0,0,8
8,0,0,0,0,0,0,0,8,8,8,8,8,8
8,1,0,0,0,0,0,0,71,0,0,0,2,8
8,8,8,8,8,8,8,8,8,8,8,8,8,8