8,8,8,8,8,8,8,8,8,8,8,8,8,8
8,0,52,0,0,8,2,71,0,0,0,1,42,8
8,0,52,0,0,8,8,8,0,0,0,0,0,8
8,0,52,0,0,52,0,0,0,0,0,0,0,8
8,611,51,31,0,52,0,0,32,0,0,0,0,8
8,0,52,0,0,52,0,0,0,0,0,0,0,8
8,0,52,0,0,0,0,0,0,0,52,0,0,8
8,0,52,0,0,0,0,0,0,0,52,0,0,8
8,0,52,31,0,0,0,0,32,0,52,0,93,8
8,8,8,8,8,8,8,8,8,8,8,8,8,8