8,8,8,8,8,8,8,8,8,8,8,8,8,8
8,91,8,0,0,8,0,0,0,8,8,0,2,8
8,0,8,94,0,52,0,0,0,621,8,0,0,8
8,71,8,0,0,8,0,0,0,8,8,8,73,8
8,0,0,0,0,72,0,0,0,0,0,0,0,8
8,0,0,0,0,8,0,0,0,0,0,0,613,8
8,0,0,0,0,8,0,0,0,8,8,0,0,8
8,44,0,32,0,51,0,0,0,612,8,0,0,8
8,1,0,0,0,8,0,0,0,8,8,0,0,8
8,8,8,8,8,8,8,8,8,8,8,8,8,8