8,8,8,8,8,8,8,8,8,8,8,8,8,8
8,0,0,0,0,32,0,51,0,0,0,0,31,8
8,0,0,0,0,0,0,8,0,0,0,0,93,8
8,0,0,0,0,0,0,71,0,0,0,1,0,8
8,0,8,8,8,0,0,8,8,8,8,8,51,8
8,0,8,612,8,0,0,8,8,8,8,8,51,8
8,0,0,0,8,0,0,72,0,0,2,8,0,8
8,0,0,0,8,0,0,8,0,0,0,8,0,8
8,0,0,0,8,31,0,51,0,0,611,8,41,8
8,8,8,8,8,8,8,8,8,8,8,8,8,8