8,8,8,8,8,8,8,8,8,8,8,8,8,8
8,0,0,0,0,51,0,0,0,0,0,0,43,8
8,0,0,0,0,8,0,0,0,0,0,0,0,8
8,0,0,0,0,8,0,0,0,0,0,0,0,8
8,32,0,0,0,8,0,0,0,0,0,0,0,8
8,0,0,0,0,71,0,0,32,0,0,0,0,8
8,0,0,0,0,8,0,0,0,0,0,0,0,8
8,0,0,0,0,8,8,8,0,0,0,0,0,8
8,1,0,611,0,8,2,72,0,0,612,0,0,8
8,8,8,8,8,8,8,8,8,8,8,8,8,8